##########
#@.......#
#........#
#..#..#..#
#........#
#.#....#.#
#..####..#
#........#
#........#
##########