###...###
#.......#
#.......#
...#.#...
....@....
...#.#...
#.......#
#.......#
###...###